                                                                                                    
                                                                                                    
                                                                                                    
                                                                                                    
                                                                                                    
                                                                                                    
54546Y                                                                                              
12121F6Y         X745454545454                                                                      
1212121F6Y       B121212121212                                                                      
121212121C       B121212121212                                                                      
12P212121C       BP21212121212                                                                      
121212121F5QRS6Y B121212121212                                                                      
121212121212121C B121212121212                                                                      
121212121212121C B1212P2121212                                                                      
121212121212P21C B121212121212                                                                      
121212121212121C B121212121212                                                                      
121212121212121C B121212121212                                                                      
121212121212121C B121212121212                                                                      
121212121D83839W VA3838E121212                                                                      
1212121D9              VAE12P2                                                                      
1212121C                 B1212                                                                      
1212121C             U   B1212                                                                      
1212121F546Y X7454545QRS5G1212                                                                      
12121212P21C B12P2121212121212                                                                      
12121212121C B1212121212121212                                                                      
12121212121C B1212121212121212                                                                      
12121212121C B1212121212121212                                                                      
121212121D9W B1212121212121212                                                                      
1212121D9W   B1212121212121212                                                                      
121DM39W     BP2121212P2121212                                                                      
121C       X7G1212121212121212                                                                      
12PC X7QRSLG121212121212121212                                                                      
121C B121212121212121212121212                                                                      
121C BP21212121212121212121212                                                                      
121C B121212121212121212121212                                                                      
121C VAE12P2121212121212121212                                                                      
121F6Y VAE12121212121212121212                                                                      
12121F6Y VAE121212121212121212                                                                      
1212121C   BP21212121212121212                                                                      
1212121C   B121212121212121212                                                                      
1212121C   B1212P2121212121212                                                                      
121DM39W   B121212121212121212                                                                      
12PC       B1212121212P2121212                                                                      
121F6      VA3N383ME1212121212                                                                      
12121F6Y      O    VAE12121212                                                                      
121212PFJ46Y         B12121212                                                                      
12121212121F6Y       VA3NE12P2                                                                      
1212121212121F6Y        OB1212                                                                      
1212121212P2121C         BP212                                                                      
121212121212121C         B1212                                                                      
121212121212121C         B1212                                                                      
121212121212121C         B1212                                                                      
121212121212121FL454546 7G1212                                                                      
12121212121212121212P2H I21212                                                                      
1212121212121212121212H I2P212                                                                      
1212121212121212121212H I21212                                                                      
12121212121212P21DN3839 AE1212                                                                      
12121212121212121CO      VAE12                                                                      
12121212121212121C         B12                                                                      
1212121212121212PC         B12                                                                      
12121212121212121C         B12                                                                      
12121212121212121C         BP2                                                                      
12121212121212121C         B12                                                                      
12121212121212P21C         B12                                                                      
12121212121212121C         B12                                                                      
12121212121212121C         B12                                                                      
12121212121212121F6Y T   X7GP2                                                                      
1212121212121212P21FKQRSJG1212                                                                      
12121212121212121212P212121212                                                                      
121212121212121212121212121212                                                                      
121212121212121212121212121212                                                                      
121212121212121212121212121212                                                                      
121212121212121212121212121212                                                                      
121212121212121212121212121212                                                                      
121212121212121212121212121212                                                                      
121212121212121212121212121212                                                                      
121212121212121212121212121212                                                                      
121212121212121212121212121212                                                                      
121212121212121212121212121212                                                                      
121212121212121212121212121212                                                                      
121212121212121212121212121212                                                                      
121212121212121212121212121212                                                                      
121212121212121212121212121212                                                                      
                                                                                                    
                                                                                                    
                                                                                                    
                                                                                                    
                                                                                                    
                                                                                                    
                                                                                                    
                                                                                                    
                                                                                                    
                                                                                                    
                                                                                                    
                                                                                                    
                                                                                                    
                                                                                                    
                                                                                                    
                                                                                                    
                                                                                                    
