                                                                                                    
                                                                                                    
                                                                                                    
546Y                           X74545454545454                                                      
121C                         X7G12121212121212                                                      
121C                       X7G1212121212121212                                                      
121C                     X7G121212121212121212                                                      
121C                   X7G12121212121212121212                                                      
121C                 X7G1212121212121212121212                                                      
121C                 B12P212121212121212121212                                                      
121F5QRS6Y           B121212121212121212121212                                                      
121212121F6Y         B121212121212121212121212                                                      
12121212121F6Y       VAE1212121212121212121212                                                      
1212121212121F6Y       VAE12121212121212121212                                                      
121212121212121F6Y       VAE121212121212121212                                                      
121212121212P2121F6Y       VAE1212121212121212                                                      
1212121212121212121F6Y       VAE12121212121212                                                      
121212121212121212121F6Y       VAE121212121212                                                      
12121212121212121212121F6Y       B121212121212                                                      
1212121212121212121212121F6Y     B121212121212                                                      
121212121212121212121212121F6Y   B121212121212                                                      
12121212121212121212121212121C   B121212121212                                                      
12121212121212121212121212121C   BP21212121212                                                      
12121212121212121212121212121C   B121212121212                                                      
12121212121212121212121212121C   B121212121212                                                      
12121212121212121212P21DM3839W   VAE1212121212                                                      
121212121212121212121D9W           VAE12121212                                                      
1212121212121212121D9W               VAE121212                                                      
1212121212121212121C                   B121212                                                      
1212121212121212121C                   B121212                                                      
1212121212121212121C                   B121212                                                      
1212121212121212121C         X74L45QRS5G121212                                                      
1212121212121212121C       X7G12P2121212121212                                                      
1212121212121212121C     X7G121212121212121212                                                      
121212121212121212PC   X7G12121212121212121212                                                      
1212121212121212121C X7G1212121212121212121212                                                      
1212121212121212121C B121212121212121212121212                                                      
1212121212121212121C B12P212121212121212121212                                                      
1212121212121212121C B121212121212121212121212                                                      
1212121212121212121C B121212121212121212121212                                                      
1212121212121212121C VAE1212121212121212121212                                                      
1212121212121212121C   VAE12121212121212121212                                                      
1212121212121212121C     B12121212121212121212                                                      
1212121212121212P21C     BP2121212121212121212                                                      
1212121212121212121C     B12121212121212121212                                                      
121212121212121212PC   X7G12121212121212121212                                                      
1212121212121212121C X7G1212121212121212121212                                                      
1212121212121212121C B121212121212121212121212                                                      
1212121212121212121C BP21212121212121212121212                                                      
1212121212P212P2121C B121212121212121212121212                                                      
12121212121DN383M39W B121212121212121212121212                                                      
12121212121CO        B121212121212121212121212                                                      
12121212121C         B121212121212121212121212                                                      
12121212121C X745QRSJG121212121212121212121212                                                      
1212121212PC B121212P2121212121212121212121212                                                      
12121212121C B12121212121212121212121212121212                                                      
121212P2121C B12121212121212121212121212121212                                                      
12121212121C BP2121212121212121212121212121212                                                      
121212121D9W B121212P2121212121212121212121212                                                      
1212121D9W   B12121212121212121212121212121212                                                      
1212121C     VAE121212121212121212121212121212                                                      
121212PC       VAE1212121212121212121212121212                                                      
1212121F6Y       VAE1212P212121212121212121212                                                      
121212121F6Y       VAE121212121212121212121212                                                      
12121212121F6Y       VAE1212121212121212121212                                                      
1212121212P21F6Y       VAE12121212121212121212                                                      
12121212P212121F6Y       VAE121212121212121212                                                      
12121212121212121F6Y       VAEP212121212121212                                                      
1212121212121212P21F6Y       B1212121212121212                                                      
121212121212121212121F6Y     B1212121212121212                                                      
12121212121212121212121F6Y   B1212121212121212                                                      
12121212121212121212P2121C   B1212121212121212                                                      
1212121212121212121212121C   B12P2121212121212                                                      
1212121212121212121212121C   B1212121212121212                                                      
12121212121212121212121D9W   B1212121212121212                                                      
1212121212121212P2121D9W     B1212121212121212                                                      
121212121212121212121C       BP212121212121212                                                      
121212121212121212121C       B1212121212121212                                                      
121212121212121212121C       B1212121212121212                                                      
1212121212121212P21D9W       B1212121212121212                                                      
12121212121212121D9W         B12P2121212121212                                                      
12121212121212121C           BP212121212121212                                                      
12121212121212P21C           B1212121212121212                                                      
1212121212121212PC         X7G1212121212121212                                                      
12121212121212121C       X7G121212121212121212                                                      
12121212121212121C     X7G12P21212121212121212                                                      
12121212121212P21C T   B1212121212121212121212                                                      
12121212121212121FKQRS6B12P2121212121212121212                                                      
1212121212121212P21212HB1212121212121212121212                                                      
1212121212121212121212HBP21212P212121212121212                                                      
1212121212121212121212HB1212121212121212121212                                                      
121212121212121212P2P2HB121D83NE12121212121212                                                      
1212121212121212121212HVA39W  OBP2121212121212                                                      
1212121212121212121212HY   U   B12121212121212                                                      
12121212121212121212P21FL45QRS5G12121212121212                                                      
1212121212121212121212121212121212121212121212                                                      
12121212121212121212121212P21212P2121212121212                                                      
1212121212121212121212121212121212121212121212                                                      
1212121212121212121212121212121212121212121212                                                      
1212121212121212121212121212121212121212121212                                                      
